.................................................................................................................................................................
    .   .         .       .     .       .   . .       .   .   .       .     .       .   .   .     .             .   .         .         .   .     .       .   . .
... . . . ....... . ..... . ... . ..... . . . . ..... ... . . . ..... . ... . ..... . . ... . ... ............. . . . ... . . . . ..... . . . ... . ..... . . . .
.   . . .   .   . . .     .   . . . .   . .   . .   . .   . .   .   . . .   . .   .   .     .   .       .     . . . . .   . . . . .     . . . . . .   . .   .   .
. ... . ... ... . . . ..... . . . . . ... ... . . . . . ... ..... . . . . ... . . ....... . ... ....... . ... . . ... ....... ... . ..... . . . . ... . ....... .
.     . . .     . . . .   . . .   . . .   .   .   . . .   .     . . . . . .   . .     .   . . . .     .   .     .   .   .   .     . .   . . .   . . . .   .     .
....... . ..... . . ... . ... ..... . . ... ......... . ......... . . ... . ... ..... . . . . . . ... ..... ....... . . ... ....... . . ... . ... . . ... . ... .
.   .   .       .   B . . .   .     .   . .     .     .   .   .   .   .   .   .   .   . . . . . . . .     .         . .   .   .   .   . .   .   .     . . . .   .
. . . ............. . . . . ... ....... . ..... . ....... . . . ....... ... ..... ....... . . . . . . ... ..... ..... ... ... . ....... . ..... ... . . . . . . .
. . . .   . .       . . . .   . . .   . . .     . .       . . .       . . . .         .   . . . .   . . .   .   .   . . .   . .         .     . .   . . .   . . .
. . . . . . . ....... . . ... . . . . . . ..... . . ....... . ... ... . . . . ....... . ... . . ..... . . ... ... . . . ... . ..... ..... ... . . ... . ..... ...
. .   . . .   .     .   .   . . . C .   .   .   . . .     . .     . . .     .     .   . .       .     .   .   .   . . .   . . .     .   . .   . .   . .     .   .
. ....... . ... . . ....... . . . . ....... . ... . ..... . ....... . . ......... . . . ............. ..... ....... ... ... . . ..... . . . ... . . ....... ... .
.       . .   . . .     .   .   . . .   .   . .   . .   .   .         . .   .     . .   .       .   .     .     .       .     . .   . .   .   . . .     . .   . .
....... . ... . . ..... . ....... . . . . ... . ... . . ..... ......... ... . ........... . . ... . ..... ..... . . ... . ..... . . . ....... . ....... . ... . .
.   .   .   . . .     .   .     . .   . .       .   . .       .   .       . .       .   . . .     . .   .     . . .   .   .   .   .       .   .     .       . . .
. . . ..... . ..... . . ....... . ....... . . ... ..... ... ..... ..... . . ....... . . . ......... . ..... . . . ... ....... ........... ... . ... ....... . . .
. . . .   . .   .   . .         . .     . . .     .     .   .   . .     .   .     .   . .     .     . .     .   . . .   .   .   .       .   .   . .     .   . . .
. . . . . . ... . ... ........... . ... ... ....... ..... ... . . . ......... . ..... . ....... . ... . . ....... . ... . . ... . ......... ..... . ... ..... . .
. .     .       .   .             .   .             .         .     .         .       .         .   .   .         .       .     .                 .   .       .  
.................................................................................................................................................................